111111111111111111111111111111
1pc000000000000000000000000001
100000000000000000000000000001
100001c0011c001c00111c111c0001
10001c0c1001c01c0001c01001c001
1001c01c0001c01c0001c0111e0001
1001111c001c001c0001c01001c001
1000001c01cc001cc001c01001c001
100000101111001110111011100001
100000000000000000000000000001
100000000000000000000000000001
111111111111111111111111111111