11111111111111111111111111111
1pc00000000000000c000000000e1
10111111111111111111111111101
1010000000000000000000000c101
10101111111111111111111111101
10100000000000000000000000001
1c111111111111111111111111101
10000000000000000000000000001
11111111111111111111111111111