111111111111
1p0000000001
100000000001
100000000001
100000000001
100000000001
100000c00001
100000000001
100000000001
100000000001
100000000001
100000000001
1000000000e1
111111111111