11111111111111111111111
10000000000000000000001
10000000000000000000001
10000000000000000000001
100000001c1c1c100000001
10000000111c11100000001
10000000c1cpc1c00000001
10000000111c11100000001
100000001c1c1c100000001
10000000000000000000001
10000000000000000000001
100000000000000000000e1
11111111111111111111111
